"cell","E","W","N","S"
"(1, 1)","1","0","0","0"
"(2, 1)","0","0","0","1"
"(3, 1)","1","0","1","1"
"(4, 1)","0","0","1","1"
"(5, 1)","0","0","1","1"
"(6, 1)","0","0","1","1"
"(7, 1)","0","0","1","1"
"(8, 1)","1","0","1","0"
"(9, 1)","0","0","0","1"
"(10, 1)","1","0","1","0"
"(1, 2)","1","1","0","0"
"(2, 2)","0","0","0","1"
"(3, 2)","0","1","1","1"
"(4, 2)","1","0","1","1"
"(5, 2)","0","0","1","1"
"(6, 2)","0","0","1","1"
"(7, 2)","1","0","1","0"
"(8, 2)","1","1","0","0"
"(9, 2)","1","0","0","1"
"(10, 2)","1","1","1","0"
"(1, 3)","1","1","0","1"
"(2, 3)","0","0","1","1"
"(3, 3)","0","0","1","1"
"(4, 3)","1","1","1","1"
"(5, 3)","0","0","1","1"
"(6, 3)","1","0","1","0"
"(7, 3)","1","1","0","0"
"(8, 3)","1","1","0","1"
"(9, 3)","0","1","1","0"
"(10, 3)","0","1","0","0"
"(1, 4)","1","1","0","1"
"(2, 4)","0","0","1","0"
"(3, 4)","0","0","0","1"
"(4, 4)","0","1","1","1"
"(5, 4)","1","0","1","0"
"(6, 4)","0","1","0","0"
"(7, 4)","0","1","0","0"
"(8, 4)","0","1","0","1"
"(9, 4)","1","0","1","1"
"(10, 4)","0","0","1","0"
"(1, 5)","0","1","0","1"
"(2, 5)","1","0","1","1"
"(3, 5)","1","0","1","0"
"(4, 5)","0","0","0","1"
"(5, 5)","0","1","1","1"
"(6, 5)","0","0","1","0"
"(7, 5)","1","0","0","1"
"(8, 5)","1","0","1","0"
"(9, 5)","0","1","0","1"
"(10, 5)","0","0","1","0"
"(1, 6)","0","0","0","1"
"(2, 6)","1","1","1","0"
"(3, 6)","0","1","0","1"
"(4, 6)","0","0","1","1"
"(5, 6)","1","0","1","1"
"(6, 6)","0","0","1","1"
"(7, 6)","1","1","1","0"
"(8, 6)","1","1","0","1"
"(9, 6)","0","0","1","1"
"(10, 6)","0","0","1","0"
"(1, 7)","1","0","0","1"
"(2, 7)","0","1","1","1"
"(3, 7)","0","0","1","0"
"(4, 7)","0","0","0","1"
"(5, 7)","0","1","1","0"
"(6, 7)","1","0","0","1"
"(7, 7)","1","1","1","0"
"(8, 7)","0","1","0","1"
"(9, 7)","1","0","1","0"
"(10, 7)","1","0","0","0"
"(1, 8)","1","1","0","1"
"(2, 8)","0","0","1","1"
"(3, 8)","0","0","1","1"
"(4, 8)","0","0","1","0"
"(5, 8)","1","0","0","0"
"(6, 8)","1","1","0","0"
"(7, 8)","0","1","0","1"
"(8, 8)","1","0","1","0"
"(9, 8)","0","1","0","0"
"(10, 8)","1","1","0","0"
"(1, 9)","0","1","0","1"
"(2, 9)","0","0","1","1"
"(3, 9)","1","0","1","1"
"(4, 9)","1","0","1","0"
"(5, 9)","0","1","0","1"
"(6, 9)","1","1","1","1"
"(7, 9)","1","0","1","0"
"(8, 9)","1","1","0","1"
"(9, 9)","1","0","1","1"
"(10, 9)","0","1","1","0"
"(1, 10)","0","0","0","1"
"(2, 10)","0","0","1","1"
"(3, 10)","0","1","1","0"
"(4, 10)","0","1","0","1"
"(5, 10)","0","0","1","0"
"(6, 10)","0","1","0","0"
"(7, 10)","0","1","0","0"
"(8, 10)","0","1","0","0"
"(9, 10)","0","1","0","1"
"(10, 10)","0","0","1","0"
